2 5 2 5 5 5 5 3 5 5 5 5 5 5 5
5 5 5 0 0 0 0 0 5 5 5 5 5 5 5
5 2 5 0 5 5 5 5 5 5 2 5 2 5 5
2 5 5 0 5 5 5 5 2 5 5 2 5 2 2
2 5 0 0 5 5 5 5 5 5 5 5 5 5 5
5 5 0 5 5 5 5 5 5 5 2 5 5 5 5
5 5 0 0 0 0 0 0 5 5 2 5 2 5 5
5 5 5 5 5 5 5 0 5 5 5 5 5 5 5
5 2 2 5 2 5 5 0 5 5 0 0 0 5 5
5 2 2 5 5 5 5 0 5 5 0 2 0 5 5
2 5 2 5 5 2 5 0 0 0 0 5 0 5 2
2 5 2 5 5 5 5 5 5 5 2 5 0 5 2
2 5 2 5 5 5 5 5 5 5 2 5 4 5 2
